1111111111111
1EP00000C00C1
1111111111111
