NO resource/texture/wall_1.xpm
SO resource/texture/wall_2.xpm
EA resource/texture/wall_3.xpm
WE resource/texture/wall_4.xpm

F 80,80,80
C 66,49,137

        1111111111111111111111111
        1100000001100000000000001
        1011000001110000000000001
        1001000000000000000000001
111111111011000001110000000000001
10000000001100000111011111P111111
11110111111111011100000010001
11110111111111011101010010001
11000000110101011100000010001
10000000000000000P00000010001
10000000000000001101010010001
110000011101010111110110000011111
1111011111110101 101111010N01
11111111 1111111 1111111111111